аэропОрты - аэропортЫ
бАнты - бантЫ
бОроду - бородУ
бухгАлтеров - бухгалтерОв
вероисповЕдание - вероисповедАние
водопровОд - водопрОвод
газопровОд - газопрОвод
граждАнство - грАжданство
дефИс - дЕфис
дешевИзна - дешевизнА
диспансЕр - диспАнсер
договорЁнность - договОренность
докумЕнт - докУмент
досУг - дОсуг
еретИк - ерЕтик
жалюзИ - жАлюзи
знАчимость - значИмость
Иксы - иксЫ
каталОг - катАлог
квартАл - квАртал
киломЕтр - килОметр
кОнусов - конусОв
корЫсть - кОрысть
крАны - кранЫ
кремЕнь - крЕмень
кремнЯ - крЕмня
лЕкторов - лекторОв
лОктя - локтЯ
лыжнЯ - лЫжня
мЕстностей - местностЕй
намЕрение - намерЕние
нарОст - нАрост
нЕдруг - недрУг
недУг - нЕдуг
некролОг - некрОлог
нЕнависть - ненавИсть
нефтепровОд - нефтепрОвод
новостЕй - нОвостей
нОвость - новОсть
ногтЕй - нОгтей
нОготь - ногОть
нОгтя - ногтЯ
Отзыв (о книге) - отзЫв
отзЫв (посла из страны) - Отзыв
Отрочество - отрОчество
партЕр - пАртер
портфЕль - пОртфель
пОручни - порУчни
придАное - прИданое
призЫв - прИзыв
свЁкла - свеклА
сирОты - сИроты
созЫв - сОзыв
сосредотОчение - сосредоточЕние
срЕдства - средствА
стАтуя - статУя
столЯр - стОляр
тамОжня - тАможня
тОрты - тортЫ
тУфля - туфлЯ
цемЕнт - цЕмент
цЕнтнер - центнЕр
цепОчка - цЕпочка
шАрфы - шарфЫ
шофЁр - шОфер
экспЕрт - Эксперт
вернА - вЕрна
знАчимый - значИмый
красИвее - красивЕе
кУхонный - кухОнный
ловкА - лОвка
мозаИчный - мозАичный
оптОвый - Оптовый
прозорлИвый - прозОрливый
прозорлИва - прозОрлива
слИвовый - сливОвый
бралА - брАла
бралАсь - брАлась
взялА - взЯла
взялАсь - взЯлась
влилАсь - влИлась
ворвалАсь - ворвАлась
воспринЯть - воспрИнять
воспринялА - воспринЯла
воссоздалА - воссоздАла
вручИт - врУчит
вручИть - врУчить
гналА - гнАла
гналАсь - гнАлась
добралА - добрАла
добралАсь - добрАлась
дождалАсь - дождАлась
дозвонИтся - дозвОнится
дозвонИться - дозвОниться
дозИровать - дозировАть
ждалА - ждАла
жилОсь - жИлось
закУпорить - закупОрить
занЯть - зАнять
зАнял - занЯл
занялА - занЯла
зАняли - занЯли
заперлА - зАперла
запломбировАть - запломбИровать
защемИт - защЕмит
звалА - звАла
звонИт - звОнит
кАшлянуть - кашлянУть
клАла - клалА
клЕить - клеИть
крАлась - кралАсь
кровоточИть - кровотОчить
лгалА - лгАла
лилА - лИла
лилАсь - лИлась
навралА - наврАла
наделИт - надЕлит
надорвалАсь - надорвАлась
назвалАсь - назвАлась
накренИтся - накрЕнится
налилА - налИла
нарвалА - нарвАла
начАть - нАчать
нАчал - начАл
началА - нАчала
нАчали - начАли
обзвонИт - обзвОнит
облегчИть - облЕгчить
облегчИт - облЕгчит
облилАсь - облИлась
обнялАсь - обнЯлась
обогналА - обогнАла
ободралА - ободрАла
ободрИть - обОдрить
ободрИт - обОдрит
одолжИт - одОлжит
положИл - полОжил
занятА - зАнята
ободрИться - обОдриться
обострИть - обОстрить
одолжИть - одОлжить
озлОбить - озлобИть
оклЕить - оклеИть
окружИт - окрУжит
опОшлить - опошлИть
освЕдомиться - осведомИтьсяя
освЕдомится - осведомИтся
отбылА - отбЫла
отдалА - отдАла
откУпорить - откупорИть
отозвалА - отозвАла
отозвалАсь - отозвАлась
перезвонИт - перезвОнит
перелилА - перелИла
плодоносИть - плодонОсить
пломбировАть - пломбИровать
повторИт - повтОрит
позвалА - позвАла
позвонИт - позвОнит
положИть - полОжить
понялА - пОняла
послАла - послалА
прибЫть - прИбыть
прИбыл - прибЫл
прибылА - прИбыла
прИбыли - прибылИ
принЯть - прИнять
прИнял - принЯл
принялА - прИняла
прИняли - принЯли
рвалА - рвАла
сверлИт - свЕрлит
снялА - снЯла
совралА - соврАла
создалА - создАла
сорвалА - сорвАла
сорИт - сОрит
убралА - убрАла
углубИть - углУбить
укрепИт - укрЕпит
чЕрпать - черпАть
щемИт - щЕмит
щЁлкать - щелкАть
довезЁнный - довЕзенный
зАгнутый - загнУтый
зАнятый - занЯтый
зАпертый - запЁртый
заселЁнный - засЕленный
заселенА - засЕлена
кормЯщий - кОрмящий
кровоточАщий - кровотОчащий
нажИвший - нАживший
налИвший - нАливший
нанЯвшийся - нАнявший
начАвший - нАчавший
нАчатый - начАтый
низведЁнный - низвЕденный
облегчЁнный - облЕгченный
ободрЁнный - обОдренный
обострЁнный - обОстренный
отключЁнный - отклЮченный
повторЁнный - повтОренный
поделЁнный - подЕленный
понЯвший - пОнявший
прИнятый - принЯтый
принятА - принЯта
приручЁнный - прирУченный
прожИвший - прОживший
снятА - снЯта
снЯтый - снятЫй
сОгнутый - согнУтый
углублЁнный - углУбленный
закУпорив - закупОрив
начАв - нАчав
начАвшись - нАчавшись
отдАв - Отдав
поднЯв - пОдняв
понЯв - пОняв
прибЫв - прИбыв
создАв - сОздав
вОвремя - воврЕмя
дОверху - довЕрху
донЕльзя - дОнельзя
дОнизу - донИзу
дОсуха - досУха
зАсветло - засвЕтло
зАтемно - затЁмно